120,40
111111111111111111111111111111111111111111111111111111111111111111111111111111111111111111111111111111111111111111111111
100000000000000000000000001100000000000000000000000000000000000000000000000000000000100000000000000000000000000000000001
100000000000000000000000000000000000000000000000000000000000000000000000000000000000100000000100000000000000000000000001
100000000000000000000000000000000000000000000000000000000000000000000000000000000000111111000100000000000000000000000001
100000001110000000000111111000000000000000000000000000000000000000000000000000000000100000000100000000000000000000000001
100000000011100000000100001000000000000011111100000000000000000000000000000000000000100000000100000000000000000000000001
100000000000110000000111111000000000000000000000000000000000000000000000000000000000111111111100000000000000000000000001
100000000000110000000100000001100000000000000000000000000000000000000000000000000000000000000000000000000000000000000001
100000000000111110000100000000100000000000000000000000000000000000000000000000000000000000000000000000000000000000000001
100000001111000000000100000011100000000000000000000000000000000000000000000000000000000000000000000000000000000000000001
100000000000000000000000000000000000000000000000000000000000000000000000000111000000000000000000000000000000000000000001
100000000000000000000000000000000000000000000000000000000000000000000000000111000000000000000000000000000000000000000001
100000000000000000000000000000000000000000000000000000000000000000000000000000000000000000000000000000000000000000000001
100000000000000000000000000000000000000000000000000000000000000000000000000000000000000000000000000000000000000000000001
100000000000000000000000000010000000000000000001011111111111100000000000000000000000000000000000000000000000000000000001
100000000000000000000000000010000000000000000001010000000000100000000000000000000000000000000000000000000000000000000001
100000000000000000000000000000000000000000000001010111111110100000000000000000000000000000000000000000000000000000000001
100000000000000000000000000000000000000000000001010000000010100000000000000000000000000000000000000000000000000000000001
100000000000000000000000000000000000000000000001011111111110100000000000000000000000000000000000000000000000000000000001
100000000000000000000000000000000000000000000001000000000000100000000000000000000000000000000000000000000000000000000001
100000000000000000000000000000000000000000000001111111111111100000000000000000000000000000000000000000000000000000000001
100000000000000000000000000000000000000000000000000000000000000000000000000000000000100000000000000000000000000000000001
100000000000000000000000000000000000000000000000000000000000000000000000000000000000100000000100000000000000000000000001
100000000000000000000000000000000000000000000000000000000000000000000000000000000000111111000100000000000000000000000001
100000000000000000000000000000000000000000000000000000000000000000000000000000000000100000000100000000000000000000000001
100000000000000000000000000000000000000011111100000000000000000000000000000000000000100000000100000000000000000000000001
100000000000000000000000000000000000000000000000000000000000000000000000000000000000111111111100000000000000000000000001
100000000000000000000000000000000000000000000000000000000000000000000000000000000000000000000000000000000000000000000001
100000000000000000000000000000000000000000000000000000000000000000000000000000000000000000000000000000000000000000000001
100000000000000000000000000000000000000000000000000000000000000000000000000000000000000000000000000000000000000000000001
100000000000000000000000000000000000000000000000000000000000000000000000000111000000000000000000000000000000000000000001
100000000000000000000000000000000000000000000000000000000000000000000000000111000000000000000000000000000000000000000001
100000000000000000000000000000000000000000000000000000000000000000000000000000000000000000000000000000000000000000000001
100000000000000000000000000000000000000000000000000000000000000000000000000000000000000000000000000000000000000000000001
100000000000000000000000000010000000000000000000000000000000000000000000000000000000000000000000000000000000000000000001
100000000000000000000000000010000000000000000000000000000000000000000000000000000000000000000000000000000000000000000001
100000000000000000000000000000000000000000000000000000000000000000000000000000000000000000000000000000000000000000000001
100000000000000000000000000000000000000000000000000000000000000000000000000000000000000000000000000000000000000000000001
100000000000000000000000000000000000000000000000000000000000000000000000000000000000000000000000000000000000000000000001
111111111111111111111111111111111111111111111111111111111111111111111111111111111111111111111111111111111111111111111111